그는	ᄀ ᅳ ᄂ ᅳ ᆫ
괜찮은	ᄀ ᅫ ᆫ ᄎ ᅡ ᆭ ᄋ ᅳ ᆫ
척하려고	ᄎ ᅥ ᆨ ᄒ ᅡ ᄅ ᅧ ᄀ ᅩ
애쓰는	ᄋ ᅢ ᄊ ᅳ ᄂ ᅳ ᆫ
것	ᄀ ᅥ ᆺ
같았다	ᄀ ᅡ ᇀ ᄋ ᅡ ᆻ ᄃ ᅡ
그녀의	ᄀ ᅳ ᄂ ᅧ ᄋ ᅴ
사랑을	ᄉ ᅡ ᄅ ᅡ ᆼ ᄋ ᅳ ᆯ
얻기	ᄋ ᅥ ᆮ ᄀ ᅵ
위해	ᄋ ᅱ ᄒ ᅢ
애썼지만	ᄋ ᅢ ᄊ ᅥ ᆻ ᄌ ᅵ ᄆ ᅡ ᆫ
헛수고였다	ᄒ ᅥ ᆺ ᄉ ᅮ ᄀ ᅩ ᄋ ᅧ ᆻ ᄃ ᅡ
용돈을	ᄋ ᅭ ᆼ ᄃ ᅩ ᆫ ᄋ ᅳ ᆯ
아껴	ᄋ ᅡ ᄁ ᅧ
써라	ᄊ ᅥ ᄅ ᅡ
아내를	ᄋ ᅡ ᄂ ᅢ ᄅ ᅳ ᆯ
많이	ᄆ ᅡ ᆭ ᄋ ᅵ
아낀다	ᄋ ᅡ ᄁ ᅵ ᆫ ᄃ ᅡ
차에	ᄎ ᅡ ᄋ ᅦ
대해	ᄃ ᅢ ᄒ ᅢ
잘	ᄌ ᅡ ᆯ
아세요	ᄋ ᅡ ᄉ ᅦ ᄋ ᅭ
거기	ᄀ ᅥ ᄀ ᅵ
도착하면	ᄃ ᅩ ᄎ ᅡ ᆨ ᄒ ᅡ ᄆ ᅧ ᆫ
나한테	ᄂ ᅡ ᄒ ᅡ ᆫ ᄐ ᅦ
알려	ᄋ ᅡ ᆯ ᄅ ᅧ
줘	ᄌ ᅯ
그들은	ᄀ ᅳ ᄃ ᅳ ᆯ ᄋ ᅳ ᆫ
내가	ᄂ ᅢ ᄀ ᅡ
시험에	ᄉ ᅵ ᄒ ᅥ ᆷ ᄋ ᅦ
떨어졌다고	ᄄ ᅥ ᆯ ᄋ ᅥ ᄌ ᅧ ᆻ ᄃ ᅡ ᄀ ᅩ
알려왔다	ᄋ ᅡ ᆯ ᄅ ᅧ ᄋ ᅪ ᆻ ᄃ ᅡ
나는	ᄂ ᅡ ᄂ ᅳ ᆫ
살아오면서	ᄉ ᅡ ᆯ ᄋ ᅡ ᄋ ᅩ ᄆ ᅧ ᆫ ᄉ ᅥ
감기를	ᄀ ᅡ ᆷ ᄀ ᅵ ᄅ ᅳ ᆯ
앓은	ᄋ ᅡ ᆶ ᄋ ᅳ ᆫ
적이	ᄌ ᅥ ᆨ ᄋ ᅵ
한	ᄒ ᅡ ᆫ
번도	ᄇ ᅥ ᆫ ᄃ ᅩ
없다	ᄋ ᅥ ᆹ ᄃ ᅡ
사흘	ᄉ ᅡ ᄒ ᅳ ᆯ
동안	ᄃ ᅩ ᆼ ᄋ ᅡ ᆫ
심하게	ᄉ ᅵ ᆷ ᄒ ᅡ ᄀ ᅦ
몸살을	ᄆ ᅩ ᆷ ᄉ ᅡ ᆯ ᄋ ᅳ ᆯ
앓았어요	ᄋ ᅡ ᆶ ᄋ ᅡ ᆻ ᄋ ᅥ ᄋ ᅭ
요즘	ᄋ ᅭ ᄌ ᅳ ᆷ
공부가	ᄀ ᅩ ᆼ ᄇ ᅮ ᄀ ᅡ
안돼요	ᄋ ᅡ ᆫ ᄃ ᅫ ᄋ ᅭ
장사가	ᄌ ᅡ ᆼ ᄉ ᅡ ᄀ ᅡ
안돼서	ᄋ ᅡ ᆫ ᄃ ᅫ ᄉ ᅥ
우울해	ᄋ ᅮ ᄋ ᅮ ᆯ ᄒ ᅢ
아무	ᄋ ᅡ ᄆ ᅮ
것도	ᄀ ᅥ ᆺ ᄃ ᅩ
먹지	ᄆ ᅥ ᆨ ᄌ ᅵ
않으면	ᄋ ᅡ ᆭ ᄋ ᅳ ᄆ ᅧ ᆫ
죽게	ᄌ ᅮ ᆨ ᄀ ᅦ
되어	ᄃ ᅬ ᄋ ᅥ
있다	ᄋ ᅵ ᆻ ᄃ ᅡ
그녀는	ᄀ ᅳ ᄂ ᅧ ᄂ ᅳ ᆫ
이유를	ᄋ ᅵ ᄋ ᅲ ᄅ ᅳ ᆯ
묻지	ᄆ ᅮ ᆮ ᄌ ᅵ
않고	ᄋ ᅡ ᆭ ᄀ ᅩ
돈을	ᄃ ᅩ ᆫ ᄋ ᅳ ᆯ
빌려	ᄇ ᅵ ᆯ ᄅ ᅧ
주었다	ᄌ ᅮ ᄋ ᅥ ᆻ ᄃ ᅡ
아기를	ᄋ ᅡ ᄀ ᅵ ᄅ ᅳ ᆯ
안고	ᄋ ᅡ ᆫ ᄀ ᅩ
있을게	ᄋ ᅵ ᆻ ᄋ ᅳ ᆯ ᄀ ᅦ
엄마는	ᄋ ᅥ ᆷ ᄆ ᅡ ᄂ ᅳ ᆫ
말없이	ᄆ ᅡ ᆯ ᄋ ᅥ ᆹ ᄋ ᅵ
나를	ᄂ ᅡ ᄅ ᅳ ᆯ
꼭	ᄁ ᅩ ᆨ
안아	ᄋ ᅡ ᆫ ᄋ ᅡ
주셨다	ᄌ ᅮ ᄉ ᅧ ᆻ ᄃ ᅡ
자리에	ᄌ ᅡ ᄅ ᅵ ᄋ ᅦ
앉으세요	ᄋ ᅡ ᆬ ᄋ ᅳ ᄉ ᅦ ᄋ ᅭ
여자가	ᄋ ᅧ ᄌ ᅡ ᄀ ᅡ
내	ᄂ ᅢ
옆에	ᄋ ᅧ ᇁ ᄋ ᅦ
앉았다	ᄋ ᅡ ᆬ ᄋ ᅡ ᆻ ᄃ ᅡ
일일사에	ᄋ ᅵ ᆯ ᄋ ᅵ ᆯ ᄉ ᅡ ᄋ ᅦ
전화를	ᄌ ᅥ ᆫ ᄒ ᅪ ᄅ ᅳ ᆯ
해서	ᄒ ᅢ ᄉ ᅥ
번호를	ᄇ ᅥ ᆫ ᄒ ᅩ ᄅ ᅳ ᆯ
알아보시지	ᄋ ᅡ ᆯ ᄋ ᅡ ᄇ ᅩ ᄉ ᅵ ᄌ ᅵ
그러세요	ᄀ ᅳ ᄅ ᅥ ᄉ ᅦ ᄋ ᅭ
누군지	ᄂ ᅮ ᄀ ᅮ ᆫ ᄌ ᅵ
알아보겠니	ᄋ ᅡ ᆯ ᄋ ᅡ ᄇ ᅩ ᄀ ᅦ ᆻ ᄂ ᅵ
절대	ᄌ ᅥ ᆯ ᄃ ᅢ
다른	ᄃ ᅡ ᄅ ᅳ ᆫ
사람의	ᄉ ᅡ ᄅ ᅡ ᆷ ᄋ ᅴ
의견을	ᄋ ᅴ ᄀ ᅧ ᆫ ᄋ ᅳ ᆯ
받아들이지	ᄇ ᅡ ᆮ ᄋ ᅡ ᄃ ᅳ ᆯ ᄋ ᅵ ᄌ ᅵ
않는다	ᄋ ᅡ ᆭ ᄂ ᅳ ᆫ ᄃ ᅡ
아이들도	ᄋ ᅡ ᄋ ᅵ ᄃ ᅳ ᆯ ᄃ ᅩ
언젠가는	ᄋ ᅥ ᆫ ᄌ ᅦ ᆫ ᄀ ᅡ ᄂ ᅳ ᆫ
그녀를	ᄀ ᅳ ᄂ ᅧ ᄅ ᅳ ᆯ
엄마로	ᄋ ᅥ ᆷ ᄆ ᅡ ᄅ ᅩ
받아들일	ᄇ ᅡ ᆮ ᄋ ᅡ ᄃ ᅳ ᆯ ᄋ ᅵ ᆯ
거야	ᄀ ᅥ ᄋ ᅣ
어디에서	ᄋ ᅥ ᄃ ᅵ ᄋ ᅦ ᄉ ᅥ
영어를	ᄋ ᅧ ᆼ ᄋ ᅥ ᄅ ᅳ ᆯ
배우셨어요	ᄇ ᅢ ᄋ ᅮ ᄉ ᅧ ᆻ ᄋ ᅥ ᄋ ᅭ
동료에게서	ᄃ ᅩ ᆼ ᄅ ᅭ ᄋ ᅦ ᄀ ᅦ ᄉ ᅥ
수화를	ᄉ ᅮ ᄒ ᅪ ᄅ ᅳ ᆯ
배우고	ᄇ ᅢ ᄋ ᅮ ᄀ ᅩ
있습니다	ᄋ ᅵ ᆻ ᄉ ᅳ ᆸ ᄂ ᅵ ᄃ ᅡ
이거	ᄋ ᅵ ᄀ ᅥ
걸로	ᄀ ᅥ ᆯ ᄅ ᅩ
바꿀	ᄇ ᅡ ᄁ ᅮ ᆯ
수	ᄉ ᅮ
있을까요	ᄋ ᅵ ᆻ ᄋ ᅳ ᆯ ᄁ ᅡ ᄋ ᅭ
색깔을	ᄉ ᅢ ᆨ ᄁ ᅡ ᆯ ᄋ ᅳ ᆯ
바꾸는	ᄇ ᅡ ᄁ ᅮ ᄂ ᅳ ᆫ
게	ᄀ ᅦ
나을	ᄂ ᅡ ᄋ ᅳ ᆯ
거	ᄀ ᅥ
같아	ᄀ ᅡ ᇀ ᄋ ᅡ
소영이	ᄉ ᅩ ᄋ ᅧ ᆼ ᄋ ᅵ
좀	ᄌ ᅩ ᆷ
바꿔	ᄇ ᅡ ᄁ ᅯ
주세요	ᄌ ᅮ ᄉ ᅦ ᄋ ᅭ
눈이	ᄂ ᅮ ᆫ ᄋ ᅵ
얼음으로	ᄋ ᅥ ᆯ ᄋ ᅳ ᆷ ᄋ ᅳ ᄅ ᅩ
바뀌었어	ᄇ ᅡ ᄁ ᅱ ᄋ ᅥ ᆻ ᄋ ᅥ
핸드폰이	ᄒ ᅢ ᆫ ᄃ ᅳ ᄑ ᅩ ᆫ ᄋ ᅵ
네	ᄂ ᅦ
거랑	ᄀ ᅥ ᄅ ᅡ ᆼ
바뀐	ᄇ ᅡ ᄁ ᅱ ᆫ
그	ᄀ ᅳ
차는	ᄎ ᅡ ᄂ ᅳ ᆫ
들판에	ᄃ ᅳ ᆯ ᄑ ᅡ ᆫ ᄋ ᅦ
버려진	ᄇ ᅥ ᄅ ᅧ ᄌ ᅵ ᆫ
채	ᄎ ᅢ
발견됐다	ᄇ ᅡ ᆯ ᄀ ᅧ ᆫ ᄃ ᅫ ᆻ ᄃ ᅡ
이번	ᄋ ᅵ ᄇ ᅥ ᆫ
달	ᄃ ᅡ ᆯ
초에	ᄎ ᅩ ᄋ ᅦ
상어떼가	ᄉ ᅡ ᆼ ᄋ ᅥ ᄄ ᅦ ᄀ ᅡ
해안가에서	ᄒ ᅢ ᄋ ᅡ ᆫ ᄀ ᅡ ᄋ ᅦ ᄉ ᅥ
오타를	ᄋ ᅩ ᄐ ᅡ ᄅ ᅳ ᆯ
발견하시는	ᄇ ᅡ ᆯ ᄀ ᅧ ᆫ ᄒ ᅡ ᄉ ᅵ ᄂ ᅳ ᆫ
분께	ᄇ ᅮ ᆫ ᄁ ᅦ
사례하겠습니다	ᄉ ᅡ ᄅ ᅨ ᄒ ᅡ ᄀ ᅦ ᆻ ᄉ ᅳ ᆸ ᄂ ᅵ ᄃ ᅡ
결국	ᄀ ᅧ ᆯ ᄀ ᅮ ᆨ
그의	ᄀ ᅳ ᄋ ᅴ
개가	ᄀ ᅢ ᄀ ᅡ
시신을	ᄉ ᅵ ᄉ ᅵ ᆫ ᄋ ᅳ ᆯ
발견했다	ᄇ ᅡ ᆯ ᄀ ᅧ ᆫ ᄒ ᅢ ᆻ ᄃ ᅡ
정신분석학은	ᄌ ᅥ ᆼ ᄉ ᅵ ᆫ ᄇ ᅮ ᆫ ᄉ ᅥ ᆨ ᄒ ᅡ ᆨ ᄋ ᅳ ᆫ
이십세기에	ᄋ ᅵ ᄉ ᅵ ᆸ ᄉ ᅦ ᄀ ᅵ ᄋ ᅦ
급격히	ᄀ ᅳ ᆸ ᄀ ᅧ ᆨ ᄒ ᅵ
발전했다	ᄇ ᅡ ᆯ ᄌ ᅥ ᆫ ᄒ ᅢ ᆻ ᄃ ᅡ
한국어	ᄒ ᅡ ᆫ ᄀ ᅮ ᆨ ᄋ ᅥ
실력이	ᄉ ᅵ ᆯ ᄅ ᅧ ᆨ ᄋ ᅵ
날이	ᄂ ᅡ ᆯ ᄋ ᅵ
갈수록	ᄀ ᅡ ᆯ ᄉ ᅮ ᄅ ᅩ ᆨ
발전하는	ᄇ ᅡ ᆯ ᄌ ᅥ ᆫ ᄒ ᅡ ᄂ ᅳ ᆫ
것을	ᄀ ᅥ ᆺ ᄋ ᅳ ᆯ
보니	ᄇ ᅩ ᄂ ᅵ
기쁩니다	ᄀ ᅵ ᄈ ᅳ ᆸ ᄂ ᅵ ᄃ ᅡ
죄송하지만	ᄌ ᅬ ᄉ ᅩ ᆼ ᄒ ᅡ ᄌ ᅵ ᄆ ᅡ ᆫ
제	ᄌ ᅦ
이름을	ᄋ ᅵ ᄅ ᅳ ᆷ ᄋ ᅳ ᆯ
밝힐	ᄇ ᅡ ᆰ ᄒ ᅵ ᆯ
수는	ᄉ ᅮ ᄂ ᅳ ᆫ
없어요	ᄋ ᅥ ᆹ ᄋ ᅥ ᄋ ᅭ
정전이	ᄌ ᅥ ᆼ ᄌ ᅥ ᆫ ᄋ ᅵ
촛불을	ᄎ ᅩ ᆺ ᄇ ᅮ ᆯ ᄋ ᅳ ᆯ
밝혔다	ᄇ ᅡ ᆰ ᄒ ᅧ ᆻ ᄃ ᅡ
모두가	ᄆ ᅩ ᄃ ᅮ ᄀ ᅡ
통과했음을	ᄐ ᅩ ᆼ ᄀ ᅪ ᄒ ᅢ ᆻ ᄋ ᅳ ᆷ ᄋ ᅳ ᆯ
발표하게	ᄇ ᅡ ᆯ ᄑ ᅭ ᄒ ᅡ ᄀ ᅦ
기쁘게	ᄀ ᅵ ᄈ ᅳ ᄀ ᅦ
생각합니다	ᄉ ᅢ ᆼ ᄀ ᅡ ᆨ ᄒ ᅡ ᆸ ᄂ ᅵ ᄃ ᅡ
밴드는	ᄇ ᅢ ᆫ ᄃ ᅳ ᄂ ᅳ ᆫ
첫	ᄎ ᅥ ᆺ
음반을	ᄋ ᅳ ᆷ ᄇ ᅡ ᆫ ᄋ ᅳ ᆯ
발표한	ᄇ ᅡ ᆯ ᄑ ᅭ ᄒ ᅡ ᆫ
직후에	ᄌ ᅵ ᆨ ᄒ ᅮ ᄋ ᅦ
해체했다	ᄒ ᅢ ᄎ ᅦ ᄒ ᅢ ᆻ ᄃ ᅡ
화재가	ᄒ ᅪ ᄌ ᅢ ᄀ ᅡ
발생하지	ᄇ ᅡ ᆯ ᄉ ᅢ ᆼ ᄒ ᅡ ᄌ ᅵ
않도록	ᄋ ᅡ ᆭ ᄃ ᅩ ᄅ ᅩ ᆨ
조심해라	ᄌ ᅩ ᄉ ᅵ ᆷ ᄒ ᅢ ᄅ ᅡ
어제	ᄋ ᅥ ᄌ ᅦ
일본에서	ᄋ ᅵ ᆯ ᄇ ᅩ ᆫ ᄋ ᅦ ᄉ ᅥ
태풍이	ᄐ ᅢ ᄑ ᅮ ᆼ ᄋ ᅵ
발생했다	ᄇ ᅡ ᆯ ᄉ ᅢ ᆼ ᄒ ᅢ ᆻ ᄃ ᅡ
돌고래는	ᄃ ᅩ ᆯ ᄀ ᅩ ᄅ ᅢ ᄂ ᅳ ᆫ
지능이	ᄌ ᅵ ᄂ ᅳ ᆼ ᄋ ᅵ
발달했다	ᄇ ᅡ ᆯ ᄃ ᅡ ᆯ ᄒ ᅢ ᆻ ᄃ ᅡ
이	ᄋ ᅵ
지역에는	ᄌ ᅵ ᄋ ᅧ ᆨ ᄋ ᅦ ᄂ ᅳ ᆫ
농업이	ᄂ ᅩ ᆼ ᄋ ᅥ ᆸ ᄋ ᅵ
발달했어요	ᄇ ᅡ ᆯ ᄃ ᅡ ᆯ ᄒ ᅢ ᆻ ᄋ ᅥ ᄋ ᅭ
제안에	ᄌ ᅦ ᄋ ᅡ ᆫ ᄋ ᅦ
반대했다	ᄇ ᅡ ᆫ ᄃ ᅢ ᄒ ᅢ ᆻ ᄃ ᅡ
저는	ᄌ ᅥ ᄂ ᅳ ᆫ
무력	ᄆ ᅮ ᄅ ᅧ ᆨ
사용을	ᄉ ᅡ ᄋ ᅭ ᆼ ᄋ ᅳ ᆯ
반대합니다	ᄇ ᅡ ᆫ ᄃ ᅢ ᄒ ᅡ ᆸ ᄂ ᅵ ᄃ ᅡ
밤늦게	ᄇ ᅡ ᆷ ᄂ ᅳ ᆽ ᄀ ᅦ
남의	ᄂ ᅡ ᆷ ᄋ ᅴ
집을	ᄌ ᅵ ᆸ ᄋ ᅳ ᆯ
방문하는	ᄇ ᅡ ᆼ ᄆ ᅮ ᆫ ᄒ ᅡ ᄂ ᅳ ᆫ
것은	ᄀ ᅥ ᆺ ᄋ ᅳ ᆫ
실례다	ᄉ ᅵ ᆯ ᄅ ᅨ ᄃ ᅡ
저희	ᄌ ᅥ ᄒ ᅴ
회사에	ᄒ ᅬ ᄉ ᅡ ᄋ ᅦ
방문해	ᄇ ᅡ ᆼ ᄆ ᅮ ᆫ ᄒ ᅢ
주셔서	ᄌ ᅮ ᄉ ᅧ ᄉ ᅥ
감사드립니다	ᄀ ᅡ ᆷ ᄉ ᅡ ᄃ ᅳ ᄅ ᅵ ᆸ ᄂ ᅵ ᄃ ᅡ
너는	ᄂ ᅥ ᄂ ᅳ ᆫ
브레이크를	ᄇ ᅳ ᄅ ᅦ ᄋ ᅵ ᄏ ᅳ ᄅ ᅳ ᆯ
너무	ᄂ ᅥ ᄆ ᅮ
세게	ᄉ ᅦ ᄀ ᅦ
밟아	ᄇ ᅡ ᆲ ᄋ ᅡ
어떤	ᄋ ᅥ ᄄ ᅥ ᆫ
남자가	ᄂ ᅡ ᆷ ᄌ ᅡ ᄀ ᅡ
지하철에서	ᄌ ᅵ ᄒ ᅡ ᄎ ᅥ ᆯ ᄋ ᅦ ᄉ ᅥ
발을	ᄇ ᅡ ᆯ ᄋ ᅳ ᆯ
밟고	ᄇ ᅡ ᆲ ᄀ ᅩ
모른	ᄆ ᅩ ᄅ ᅳ ᆫ
척했다	ᄎ ᅥ ᆨ ᄒ ᅢ ᆻ ᄃ ᅡ
호기심으로	ᄒ ᅩ ᄀ ᅵ ᄉ ᅵ ᆷ ᄋ ᅳ ᄅ ᅩ
가득찬	ᄀ ᅡ ᄃ ᅳ ᆨ ᄎ ᅡ ᆫ
눈으로	ᄂ ᅮ ᆫ ᄋ ᅳ ᄅ ᅩ
바라보았다	ᄇ ᅡ ᄅ ᅡ ᄇ ᅩ ᄋ ᅡ ᆻ ᄃ ᅡ
문제는	ᄆ ᅮ ᆫ ᄌ ᅦ ᄂ ᅳ ᆫ
제삼자의	ᄌ ᅦ ᄉ ᅡ ᆷ ᄌ ᅡ ᄋ ᅴ
시각에서	ᄉ ᅵ ᄀ ᅡ ᆨ ᄋ ᅦ ᄉ ᅥ
바라볼	ᄇ ᅡ ᄅ ᅡ ᄇ ᅩ ᆯ
필요가	ᄑ ᅵ ᆯ ᄋ ᅭ ᄀ ᅡ
있어	ᄋ ᅵ ᆻ ᄋ ᅥ
저한테	ᄌ ᅥ ᄒ ᅡ ᆫ ᄐ ᅦ
많은	ᄆ ᅡ ᆭ ᄋ ᅳ ᆫ
걸	ᄀ ᅥ ᆯ
바라지	ᄇ ᅡ ᄅ ᅡ ᄌ ᅵ
마세요	ᄆ ᅡ ᄉ ᅦ ᄋ ᅭ
빨리	ᄈ ᅡ ᆯ ᄅ ᅵ
나으시길	ᄂ ᅡ ᄋ ᅳ ᄉ ᅵ ᄀ ᅵ ᆯ
바랍니다	ᄇ ᅡ ᄅ ᅡ ᆸ ᄂ ᅵ ᄃ ᅡ
입술에	ᄋ ᅵ ᆸ ᄉ ᅮ ᆯ ᄋ ᅦ
침이나	ᄎ ᅵ ᆷ ᄋ ᅵ ᄂ ᅡ
바르고	ᄇ ᅡ ᄅ ᅳ ᄀ ᅩ
말해	ᄆ ᅡ ᆯ ᄒ ᅢ
선크림을	ᄉ ᅥ ᆫ ᄏ ᅳ ᄅ ᅵ ᆷ ᄋ ᅳ ᆯ
발랐어야지	ᄇ ᅡ ᆯ ᄅ ᅡ ᆻ ᄋ ᅥ ᄋ ᅣ ᄌ ᅵ
생일	ᄉ ᅢ ᆼ ᄋ ᅵ ᆯ
선물로	ᄉ ᅥ ᆫ ᄆ ᅮ ᆯ ᄅ ᅩ
책을	ᄎ ᅢ ᆨ ᄋ ᅳ ᆯ
받았다	ᄇ ᅡ ᆮ ᄋ ᅡ ᆻ ᄃ ᅡ
스트레스	ᄉ ᅳ ᄐ ᅳ ᄅ ᅦ ᄉ ᅳ
받는	ᄇ ᅡ ᆮ ᄂ ᅳ ᆫ
일	ᄋ ᅵ ᆯ
어떻게	ᄋ ᅥ ᄄ ᅥ ᇂ ᄀ ᅦ
그렇게	ᄀ ᅳ ᄅ ᅥ ᇂ ᄀ ᅦ
버셨어요	ᄇ ᅥ ᄉ ᅧ ᆻ ᄋ ᅥ ᄋ ᅭ
달에	ᄃ ᅡ ᆯ ᄋ ᅦ
삼백만	ᄉ ᅡ ᆷ ᄇ ᅢ ᆨ ᄆ ᅡ ᆫ
원을	ᄋ ᅯ ᆫ ᄋ ᅳ ᆯ
법니다	ᄇ ᅥ ᆸ ᄂ ᅵ ᄃ ᅡ
입을	ᄋ ᅵ ᆸ ᄋ ᅳ ᆯ
벌려	ᄇ ᅥ ᆯ ᄅ ᅧ
보세요	ᄇ ᅩ ᄉ ᅦ ᄋ ᅭ
다리를	ᄃ ᅡ ᄅ ᅵ ᄅ ᅳ ᆯ
벌리고	ᄇ ᅥ ᆯ ᄅ ᅵ ᄀ ᅩ
앉지	ᄋ ᅡ ᆬ ᄌ ᅵ
마라	ᄆ ᅡ ᄅ ᅡ
벽	ᄇ ᅧ ᆨ
사이에	ᄉ ᅡ ᄋ ᅵ ᄋ ᅦ
벌어진	ᄇ ᅥ ᆯ ᄋ ᅥ ᄌ ᅵ ᆫ
틈이	ᄐ ᅳ ᆷ ᄋ ᅵ
법안을	ᄇ ᅥ ᆸ ᄋ ᅡ ᆫ ᄋ ᅳ ᆯ
놓고	ᄂ ᅩ ᇂ ᄀ ᅩ
말다툼이	ᄆ ᅡ ᆯ ᄃ ᅡ ᄐ ᅮ ᆷ ᄋ ᅵ
벌어졌어	ᄇ ᅥ ᆯ ᄋ ᅥ ᄌ ᅧ ᆻ ᄋ ᅥ
담배	ᄃ ᅡ ᆷ ᄇ ᅢ
꽁초를	ᄁ ᅩ ᆼ ᄎ ᅩ ᄅ ᅳ ᆯ
여기에	ᄋ ᅧ ᄀ ᅵ ᄋ ᅦ
버리지	ᄇ ᅥ ᄅ ᅵ ᄌ ᅵ
다	ᄃ ᅡ
써	ᄊ ᅥ
버렸어요	ᄇ ᅥ ᄅ ᅧ ᆻ ᄋ ᅥ ᄋ ᅭ
내년	ᄂ ᅢ ᄂ ᅧ ᆫ
아버지	ᄋ ᅡ ᄇ ᅥ ᄌ ᅵ
환갑	ᄒ ᅪ ᆫ ᄀ ᅡ ᆸ
때	ᄄ ᅢ
잔치를	ᄌ ᅡ ᆫ ᄎ ᅵ ᄅ ᅳ ᆯ
벌일	ᄇ ᅥ ᆯ ᄋ ᅵ ᆯ
오늘	ᄋ ᅩ ᄂ ᅳ ᆯ
아침	ᄋ ᅡ ᄎ ᅵ ᆷ
아내랑	ᄋ ᅡ ᄂ ᅢ ᄅ ᅡ ᆼ
말다툼을	ᄆ ᅡ ᆯ ᄃ ᅡ ᄐ ᅮ ᆷ ᄋ ᅳ ᆯ
벌였어	ᄇ ᅥ ᆯ ᄋ ᅧ ᆻ ᄋ ᅥ
가난에서	ᄀ ᅡ ᄂ ᅡ ᆫ ᄋ ᅦ ᄉ ᅥ
벗어나려면	ᄇ ᅥ ᆺ ᄋ ᅥ ᄂ ᅡ ᄅ ᅧ ᄆ ᅧ ᆫ
습관부터	ᄉ ᅳ ᆸ ᄀ ᅪ ᆫ ᄇ ᅮ ᄐ ᅥ
바꿔라	ᄇ ᅡ ᄁ ᅯ ᄅ ᅡ
복잡한	ᄇ ᅩ ᆨ ᄌ ᅡ ᆸ ᄒ ᅡ ᆫ
도시	ᄃ ᅩ ᄉ ᅵ
지역을	ᄌ ᅵ ᄋ ᅧ ᆨ ᄋ ᅳ ᆯ
벗어나니	ᄇ ᅥ ᆺ ᄋ ᅥ ᄂ ᅡ ᄂ ᅵ
참	ᄎ ᅡ ᆷ
좋군요	ᄌ ᅩ ᇂ ᄀ ᅮ ᆫ ᄋ ᅭ
신발이	ᄉ ᅵ ᆫ ᄇ ᅡ ᆯ ᄋ ᅵ
꽉	ᄁ ᅪ ᆨ
껴서	ᄁ ᅧ ᄉ ᅥ
벗을	ᄇ ᅥ ᆺ ᄋ ᅳ ᆯ
수가	ᄉ ᅮ ᄀ ᅡ
햇빛이	ᄒ ᅢ ᆺ ᄇ ᅵ ᆾ ᄋ ᅵ
비치는	ᄇ ᅵ ᄎ ᅵ ᄂ ᅳ ᆫ
상쾌하군	ᄉ ᅡ ᆼ ᄏ ᅫ ᄒ ᅡ ᄀ ᅮ ᆫ
커튼	ᄏ ᅥ ᄐ ᅳ ᆫ
너머에	ᄂ ᅥ ᄆ ᅥ ᄋ ᅦ
누군가의	ᄂ ᅮ ᄀ ᅮ ᆫ ᄀ ᅡ ᄋ ᅴ
그림자가	ᄀ ᅳ ᄅ ᅵ ᆷ ᄌ ᅡ ᄀ ᅡ
비쳤다	ᄇ ᅵ ᄎ ᅧ ᆻ ᄃ ᅡ
램프가	ᄅ ᅢ ᆷ ᄑ ᅳ ᄀ ᅡ
작품을	ᄌ ᅡ ᆨ ᄑ ᅮ ᆷ ᄋ ᅳ ᆯ
비추게	ᄇ ᅵ ᄎ ᅮ ᄀ ᅦ
배치되어	ᄇ ᅢ ᄎ ᅵ ᄃ ᅬ ᄋ ᅥ
있었다	ᄋ ᅵ ᆻ ᄋ ᅥ ᆻ ᄃ ᅡ
아침마다	ᄋ ᅡ ᄎ ᅵ ᆷ ᄆ ᅡ ᄃ ᅡ
얼굴을	ᄋ ᅥ ᆯ ᄀ ᅮ ᆯ ᄋ ᅳ ᆯ
거울에	ᄀ ᅥ ᄋ ᅮ ᆯ ᄋ ᅦ
비춰	ᄇ ᅵ ᄎ ᅯ
봐요	ᄇ ᅪ ᄋ ᅭ
금고는	ᄀ ᅳ ᆷ ᄀ ᅩ ᄂ ᅳ ᆫ
이미	ᄋ ᅵ ᄆ ᅵ
비어	ᄇ ᅵ ᄋ ᅥ
자리는	ᄌ ᅡ ᄅ ᅵ ᄂ ᅳ ᆫ
비었습니까	ᄇ ᅵ ᄋ ᅥ ᆻ ᄉ ᅳ ᆸ ᄂ ᅵ ᄁ ᅡ
우리는	ᄋ ᅮ ᄅ ᅵ ᄂ ᅳ ᆫ
서로	ᄉ ᅥ ᄅ ᅩ
답을	ᄃ ᅡ ᆸ ᄋ ᅳ ᆯ
비교해	ᄇ ᅵ ᄀ ᅭ ᄒ ᅢ
보았다	ᄇ ᅩ ᄋ ᅡ ᆻ ᄃ ᅡ
부모가	ᄇ ᅮ ᄆ ᅩ ᄀ ᅡ
저지르는	ᄌ ᅥ ᄌ ᅵ ᄅ ᅳ ᄂ ᅳ ᆫ
큰	ᄏ ᅳ ᆫ
실수	ᄉ ᅵ ᆯ ᄉ ᅮ
중	ᄌ ᅮ ᆼ
하나는	ᄒ ᅡ ᄂ ᅡ ᄂ ᅳ ᆫ
자기	ᄌ ᅡ ᄀ ᅵ
아이를	ᄋ ᅡ ᄋ ᅵ ᄅ ᅳ ᆯ
집	ᄌ ᅵ ᆸ
아이와	ᄋ ᅡ ᄋ ᅵ ᄋ ᅪ
비교하는	ᄇ ᅵ ᄀ ᅭ ᄒ ᅡ ᄂ ᅳ ᆫ
것이다	ᄀ ᅥ ᆺ ᄋ ᅵ ᄃ ᅡ
이틀	ᄋ ᅵ ᄐ ᅳ ᆯ
차를	ᄎ ᅡ ᄅ ᅳ ᆯ
빌리고	ᄇ ᅵ ᆯ ᄅ ᅵ ᄀ ᅩ
싶은데요	ᄉ ᅵ ᇁ ᄋ ᅳ ᆫ ᄃ ᅦ ᄋ ᅭ
아내에게서	ᄋ ᅡ ᄂ ᅢ ᄋ ᅦ ᄀ ᅦ ᄉ ᅥ
빌린다는	ᄇ ᅵ ᆯ ᄅ ᅵ ᆫ ᄃ ᅡ ᄂ ᅳ ᆫ
이상해요	ᄋ ᅵ ᄉ ᅡ ᆼ ᄒ ᅢ ᄋ ᅭ
다이아몬드가	ᄃ ᅡ ᄋ ᅵ ᄋ ᅡ ᄆ ᅩ ᆫ ᄃ ᅳ ᄀ ᅡ
눈부시게	ᄂ ᅮ ᆫ ᄇ ᅮ ᄉ ᅵ ᄀ ᅦ
빛나고	ᄇ ᅵ ᆾ ᄂ ᅡ ᄀ ᅩ
모든	ᄆ ᅩ ᄃ ᅳ ᆫ
창에서	ᄎ ᅡ ᆼ ᄋ ᅦ ᄉ ᅥ
촛불이	ᄎ ᅩ ᆺ ᄇ ᅮ ᆯ ᄋ ᅵ
반짝반짝	ᄇ ᅡ ᆫ ᄍ ᅡ ᆨ ᄇ ᅡ ᆫ ᄍ ᅡ ᆨ
우연히	ᄋ ᅮ ᄋ ᅧ ᆫ ᄒ ᅵ
길에서	ᄀ ᅵ ᆯ ᄋ ᅦ ᄉ ᅥ
여자를	ᄋ ᅧ ᄌ ᅡ ᄅ ᅳ ᆯ
봤어요	ᄇ ᅪ ᆻ ᄋ ᅥ ᄋ ᅭ
어디선가	ᄋ ᅥ ᄃ ᅵ ᄉ ᅥ ᆫ ᄀ ᅡ
뵌	ᄇ ᅬ ᆫ
분	ᄇ ᅮ ᆫ
같아요	ᄀ ᅡ ᇀ ᄋ ᅡ ᄋ ᅭ
지난번에	ᄌ ᅵ ᄂ ᅡ ᆫ ᄇ ᅥ ᆫ ᄋ ᅦ
후	ᄒ ᅮ
오랜만에	ᄋ ᅩ ᄅ ᅢ ᆫ ᄆ ᅡ ᆫ ᄋ ᅦ
뵙습니다	ᄇ ᅬ ᆸ ᄉ ᅳ ᆸ ᄂ ᅵ ᄃ ᅡ
그거	ᄀ ᅳ ᄀ ᅥ
맛있어	ᄆ ᅡ ᆺ ᄋ ᅵ ᆻ ᄋ ᅥ
보이네	ᄇ ᅩ ᄋ ᅵ ᄂ ᅦ
나이에	ᄂ ᅡ ᄋ ᅵ ᄋ ᅦ
비해	ᄇ ᅵ ᄒ ᅢ
정말	ᄌ ᅥ ᆼ ᄆ ᅡ ᆯ
젊어	ᄌ ᅥ ᆱ ᄋ ᅥ
보인다	ᄇ ᅩ ᄋ ᅵ ᆫ ᄃ ᅡ
그녀가	ᄀ ᅳ ᄂ ᅧ ᄀ ᅡ
나에게	ᄂ ᅡ ᄋ ᅦ ᄀ ᅦ
사진	ᄉ ᅡ ᄌ ᅵ ᆫ
몇	ᄆ ᅧ ᆾ
장을	ᄌ ᅡ ᆼ ᄋ ᅳ ᆯ
보여	ᄇ ᅩ ᄋ ᅧ
주민등록증을	ᄌ ᅮ ᄆ ᅵ ᆫ ᄃ ᅳ ᆼ ᄅ ᅩ ᆨ ᄌ ᅳ ᆼ ᄋ ᅳ ᆯ
주시겠어요	ᄌ ᅮ ᄉ ᅵ ᄀ ᅦ ᆻ ᄋ ᅥ ᄋ ᅭ
김치가	ᄀ ᅵ ᆷ ᄎ ᅵ ᄀ ᅡ
맛이	ᄆ ᅡ ᆺ ᄋ ᅵ
없어서	ᄋ ᅥ ᆹ ᄋ ᅥ ᄉ ᅥ
볶았어	ᄇ ᅩ ᆩ ᄋ ᅡ ᆻ ᄋ ᅥ
고기를	ᄀ ᅩ ᄀ ᅵ ᄅ ᅳ ᆯ
기름에	ᄀ ᅵ ᄅ ᅳ ᆷ ᄋ ᅦ
볶지	ᄇ ᅩ ᆩ ᄌ ᅵ
소포를	ᄉ ᅩ ᄑ ᅩ ᄅ ᅳ ᆯ
뉴욕으로	ᄂ ᅲ ᄋ ᅭ ᆨ ᄋ ᅳ ᄅ ᅩ
보내고	ᄇ ᅩ ᄂ ᅢ ᄀ ᅩ
선생님께	ᄉ ᅥ ᆫ ᄉ ᅢ ᆼ ᄂ ᅵ ᆷ ᄁ ᅦ
부	ᄇ ᅮ
보내	ᄇ ᅩ ᄂ ᅢ
드리겠습니다	ᄃ ᅳ ᄅ ᅵ ᄀ ᅦ ᆻ ᄉ ᅳ ᆸ ᄂ ᅵ ᄃ ᅡ
휴가	ᄒ ᅲ ᄀ ᅡ
보내세요	ᄇ ᅩ ᄂ ᅢ ᄉ ᅦ ᄋ ᅭ
짐	ᄌ ᅵ ᆷ
하나하나에	ᄒ ᅡ ᄂ ᅡ ᄒ ᅡ ᄂ ᅡ ᄋ ᅦ
이름표를	ᄋ ᅵ ᄅ ᅳ ᆷ ᄑ ᅭ ᄅ ᅳ ᆯ
붙였다	ᄇ ᅮ ᇀ ᄋ ᅧ ᆻ ᄃ ᅡ
침으로	ᄎ ᅵ ᆷ ᄋ ᅳ ᄅ ᅩ
편지	ᄑ ᅧ ᆫ ᄌ ᅵ
봉투에	ᄇ ᅩ ᆼ ᄐ ᅮ ᄋ ᅦ
우표를	ᄋ ᅮ ᄑ ᅭ ᄅ ᅳ ᆯ
붙이지	ᄇ ᅮ ᇀ ᄋ ᅵ ᄌ ᅵ
누가	ᄂ ᅮ ᄀ ᅡ
거기에	ᄀ ᅥ ᄀ ᅵ ᄋ ᅦ
가느냐는	ᄀ ᅡ ᄂ ᅳ ᄂ ᅣ ᄂ ᅳ ᆫ
별로	ᄇ ᅧ ᆯ ᄅ ᅩ
중요하지	ᄌ ᅮ ᆼ ᄋ ᅭ ᄒ ᅡ ᄌ ᅵ
않아요	ᄋ ᅡ ᆭ ᄋ ᅡ ᄋ ᅭ
사람이랑	ᄉ ᅡ ᄅ ᅡ ᆷ ᄋ ᅵ ᄅ ᅡ ᆼ
같이	ᄀ ᅡ ᇀ ᄋ ᅵ
있으면	ᄋ ᅵ ᆻ ᄋ ᅳ ᄆ ᅧ ᆫ
즐거워요	ᄌ ᅳ ᆯ ᄀ ᅥ ᄋ ᅯ ᄋ ᅭ
즐거운	ᄌ ᅳ ᆯ ᄀ ᅥ ᄋ ᅮ ᆫ
시간	ᄉ ᅵ ᄀ ᅡ ᆫ
집에만	ᄌ ᅵ ᆸ ᄋ ᅦ ᄆ ᅡ ᆫ
있는	ᄋ ᅵ ᆻ ᄂ ᅳ ᆫ
지겨워	ᄌ ᅵ ᄀ ᅧ ᄋ ᅯ
죽겠어	ᄌ ᅮ ᆨ ᄀ ᅦ ᆻ ᄋ ᅥ
수업	ᄉ ᅮ ᄋ ᅥ ᆸ
지겨웠어요	ᄌ ᅵ ᄀ ᅧ ᄋ ᅯ ᆻ ᄋ ᅥ ᄋ ᅭ
